11111111111111111111111
10000000000000000000001
10111111111111111111001
10000000000000000000001
10111111111111111111001
10000000000000000000001
10000000000000001001001
10000000000000001001001
10000111111111111001001
10000000100000001001001
10000000100000001001001
10000000100000001001001
10000000100000101001001
10000000100000101001001
10000000000000101001001
10000011111111111001001
10000000000000001001001
10001000000000001001001
10001000000000000000001
11111111111111111111111